res/tiles/world.png
697 697 697 697 697 697 697 697 697 697 697 697 697 697 697 697 697 697 697 697 697 697 697 697 697 697 697 697 697 697 697 697 697 697 697 697 697 697 697 697 697 697 697 697 697 697 697 697 697 697 697 697 697 697 697 697 697 697 697 697 697 697 697 697 697 697 697 697 697 697 697 697 697 697 697 697 697 697 697 697 697 697 697 697 697 697 697 697 697 697 697 697 697 697 697 697 697 697 697 697
697 697 697 697 697 697 697 697 697 697 697 697 697 697 697 697 697 697 697 697 697 697 697 697 697 697 697 697 697 697 697 697 697 697 697 697 697 697 697 697 697 697 697 697 697 697 697 697 697 697 697 697 697 697 697 697 697 697 697 697 697 697 697 697 697 697 697 697 697 697 697 697 697 697 697 697 697 697 697 697 697 697 697 697 697 697 697 697 697 697 697 697 697 697 697 697 697 697 697 697
697 697 697 697 697 697 697 697 697 697 697 697 697 697 697 697 697 697 697 697 697 697 697 697 697 697 697 697 697 697 697 697 697 697 697 697 697 697 697 697 697 697 697 697 697 697 697 697 697 697 697 697 697 697 697 697 697 697 697 697 697 697 697 697 697 697 697 697 697 697 697 697 697 697 697 697 697 697 697 697 697 697 697 697 697 697 697 697 697 697 697 697 697 697 697 697 697 697 697 697
697 697 697 697 697 697 697 697 697 697 697 697 697 697 697 697 697 697 697 697 697 697 697 697 697 697 697 697 697 697 697 697 697 697 697 697 697 697 697 697 697 697 697 697 697 697 697 697 697 697 697 697 697 697 697 697 697 697 697 697 697 697 697 697 697 697 697 697 697 697 697 697 697 697 697 697 697 697 697 697 697 697 697 697 697 697 697 697 697 697 697 697 697 697 697 697 697 697 697 697
697 697 697 697 697 697 697 697 697 697 697 697 697 697 697 697 697 697 697 697 697 697 697 697 697 697 697 697 697 697 697 697 697 697 697 697 697 697 697 697 697 697 697 697 697 697 697 697 697 697 697 697 697 697 697 697 697 697 697 697 697 697 697 697 697 697 697 697 697 697 697 697 697 697 697 697 697 697 697 697 697 697 697 697 697 697 697 697 697 697 697 697 697 697 697 697 697 697 697 697
697 697 697 697 697 697 697 697 697 697 697 697 697 697 697 697 697 697 697 697 697 697 697 697 697 697 697 697 697 697 697 697 697 697 697 697 697 697 697 697 697 697 697 697 697 697 697 697 697 697 697 697 697 697 697 697 697 697 697 697 697 697 697 697 697 697 697 697 697 697 697 697 697 697 697 697 697 697 697 697 697 697 697 697 697 697 697 697 697 697 697 697 697 697 697 697 697 697 697 697
697 697 697 697 697 697 697 697 697 697 697 697 697 697 697 697 697 697 697 697 697 697 697 697 697 697 697 697 697 697 697 697 697 697 697 697 697 697 697 697 697 697 697 697 697 697 697 697 697 697 697 697 697 697 697 697 697 697 697 697 697 697 697 697 697 697 697 697 697 697 697 697 697 697 697 697 697 697 697 697 697 697 697 697 697 697 697 697 697 697 697 697 697 697 697 697 697 697 697 697
697 697 697 697 697 697 697 697 697 697 697 697 697 697 697 697 697 697 697 697 697 697 697 697 697 697 697 697 697 697 697 697 697 697 697 697 697 697 697 697 697 697 697 697 697 697 697 697 697 697 697 697 697 697 697 697 697 697 697 697 697 697 697 697 697 697 697 697 697 697 697 697 697 697 697 697 697 697 697 697 697 697 697 697 697 697 697 697 697 697 697 697 697 697 697 697 697 697 697 697
697 697 697 697 697 697 697 697 697 697 697 697 697 697 697 697 697 697 697 697 697 697 697 697 697 697 697 697 697 697 697 697 697 697 697 697 697 697 697 697 697 697 697 697 697 697 697 697 697 697 697 697 697 697 697 697 697 697 697 697 697 697 697 697 697 697 697 697 697 697 697 697 697 697 697 697 697 697 697 697 697 697 697 697 697 697 697 697 697 697 697 697 697 697 697 697 697 697 697 697
697 697 697 697 697 697 697 697 697 697 697 697 697 697 697 697 697 697 697 697 697 697 697 697 697 697 697 697 697 697 697 697 697 697 697 697 697 697 697 697 697 697 697 697 697 697 697 697 697 697 697 697 697 697 697 697 697 697 697 697 697 697 697 697 697 697 697 697 697 697 697 697 697 697 697 697 697 697 697 697 697 697 697 697 697 697 697 697 697 697 697 697 697 697 697 697 697 697 697 697
697 697 697 697 697 697 697 697 697 697 697 697 697 697 697 697 697 697 697 697 697 697 697 697 697 697 697 697 697 697 697 697 697 697 697 697 697 697 697 697 697 697 697 697 697 697 697 697 697 697 697 697 697 697 697 697 697 697 697 697 697 697 697 697 697 697 697 697 697 697 697 697 697 697 697 697 697 697 697 697 697 697 697 697 697 697 697 697 697 697 697 697 697 697 697 697 697 697 697 697
697 697 697 697 697 697 697 697 697 697 697 697 697 697 697 697 697 697 697 697 697 697 697 697 697 697 697 697 697 697 697 697 697 697 697 697 697 697 697 697 697 697 697 697 697 697 697 697 697 697 697 697 697 697 697 697 697 697 697 697 697 697 697 697 697 697 697 697 697 697 697 697 697 697 697 697 697 697 697 697 697 697 697 697 697 697 697 697 697 697 697 697 697 697 697 697 697 697 697 697
697 697 697 697 697 697 697 697 697 697 697 697 697 697 697 697 697 697 697 697 697 697 697 697 697 697 697 697 697 697 697 697 697 697 697 697 697 697 697 697 697 697 697 697 697 697 697 697 697 697 697 697 697 697 697 697 697 697 697 697 697 697 697 697 697 697 697 697 697 697 697 697 697 697 697 697 697 697 697 697 697 697 697 697 697 697 697 697 697 697 697 697 697 697 697 697 697 697 697 697
697 697 697 697 697 697 697 697 697 697 697 697 697 697 697 697 697 697 697 697 697 697 697 697 697 697 697 697 697 697 697 697 697 697 697 697 697 697 697 697 697 697 697 697 697 697 697 697 697 697 697 697 697 697 697 697 697 697 697 697 697 697 697 697 697 697 697 697 697 697 697 697 697 697 697 697 697 697 697 697 697 697 697 697 697 697 697 697 697 697 697 697 697 697 697 697 697 697 697 697
697 697 697 697 697 697 697 697 697 697 697 697 697 697 697 697 697 697 697 697 697 697 697 697 697 697 697 697 697 697 697 697 697 697 697 697 697 697 697 697 697 697 697 697 697 697 697 697 697 697 697 697 697 697 697 697 697 697 697 697 697 697 697 697 697 697 697 697 697 697 697 697 697 697 697 697 697 697 697 697 697 697 697 697 697 697 697 697 697 697 697 697 697 697 697 697 697 697 697 697
697 697 697 697 697 697 697 697 697 697 697 697 697 697 697 697 697 697 697 697 697 697 697 697 697 697 697 697 697 697 697 697 697 697 697 697 697 697 697 697 697 697 697 697 697 697 697 697 697 697 697 697 697 697 697 697 697 697 697 697 697 697 697 697 697 697 697 697 697 697 697 697 697 697 697 697 697 697 697 697 697 697 697 697 697 697 697 697 697 697 697 697 697 697 697 697 697 697 697 697
697 697 697 697 697 697 697 697 697 697 697 697 697 697 697 697 697 697 697 697 697 697 697 697 697 697 697 697 697 697 697 697 697 697 697 697 697 697 697 697 697 697 697 697 697 697 697 697 697 697 697 697 697 697 697 697 697 697 697 697 697 697 697 697 697 697 697 697 697 697 697 697 697 697 697 697 697 697 697 697 697 697 697 697 697 697 697 697 697 697 697 697 697 697 697 697 697 697 697 697
697 697 697 697 697 697 697 697 697 697 697 697 697 697 697 697 697 697 697 697 697 697 697 697 697 697 697 697 697 697 697 697 697 697 697 697 697 697 697 697 697 697 697 697 697 697 697 697 697 697 697 697 697 697 697 697 697 697 697 697 697 697 697 697 697 697 697 697 697 697 697 697 697 697 697 697 697 697 697 697 697 697 697 697 697 697 697 697 697 697 697 697 697 697 697 697 697 697 697 697
697 697 697 697 697 697 697 697 697 697 697 697 697 697 697 697 697 697 697 697 697 697 697 697 697 697 697 697 697 697 697 697 697 697 697 697 697 697 697 307 307 307 697 697 697 697 697 697 697 697 697 697 697 697 697 697 697 697 697 697 697 697 697 697 697 697 697 697 697 697 697 697 697 697 697 697 697 697 697 697 697 697 697 697 697 697 697 697 697 697 697 697 697 697 697 697 697 697 697 697
697 697 697 697 697 697 697 697 697 697 697 697 697 697 697 697 697 697 697 697 697 697 697 697 697 697 697 697 697 697 697 697 697 697 697 697 697 697 697 307 307 307 697 697 697 697 697 697 697 697 697 697 697 697 697 697 697 697 697 697 697 697 697 697 697 697 697 697 697 697 697 697 697 697 697 697 697 697 697 697 697 697 697 697 697 697 697 697 697 697 697 697 697 697 697 697 697 697 697 697
697 697 697 697 697 697 697 697 697 697 697 697 697 697 697 697 697 697 697 697 697 697 697 697 697 697 697 697 697 697 697 697 697 697 697 697 697 697 697 307 307 307 697 697 697 697 697 697 697 697 697 697 697 697 697 697 697 697 697 697 697 697 697 697 697 697 697 697 697 697 697 697 697 697 697 697 697 697 697 697 697 697 697 697 697 697 697 697 697 697 697 697 697 697 697 697 697 697 697 697
0 0 0 0 0 0 0 0 0 0 0 0 0 0 0 0 0 0 0 0 0 0 0 0 0 0 0 0 0 0 0 0 0 0 0 0 0 0 0 0 0 0 0 0 0 0 0 0 0 0 0 0 0 0 0 0 0 0 0 0 0 0 0 0 0 0 0 0 0 0 0 0 0 0 0 0 0 0 0 0 0 0 0 0 0 0 0 0 0 0 0 0 0 0 0 0 0 0 0 0
0 0 0 0 0 0 0 0 0 0 0 0 0 0 0 0 0 0 0 0 0 0 0 0 0 0 0 0 0 0 0 0 0 0 0 0 0 0 0 0 0 0 0 0 0 0 0 0 0 0 0 0 0 0 0 0 0 0 0 0 0 0 0 0 0 0 0 0 0 0 0 0 0 0 0 0 0 0 0 0 0 0 0 0 0 0 0 0 0 0 0 0 0 0 0 0 0 0 0 0
0 0 0 0 0 0 0 0 0 0 0 0 0 0 0 0 0 0 0 0 0 0 0 0 0 0 0 0 0 0 0 0 0 0 0 0 0 0 0 0 0 0 0 0 0 0 0 0 0 0 0 0 0 0 0 0 0 0 0 0 0 0 0 0 0 0 0 0 0 0 0 0 0 0 0 0 0 0 0 0 0 0 0 0 0 0 0 0 0 0 0 0 0 0 0 0 0 0 0 0
0 0 0 0 0 0 0 0 0 0 0 0 0 0 0 0 0 0 0 0 0 0 0 0 0 0 0 0 0 0 0 0 0 0 0 0 0 0 0 0 0 0 0 0 0 0 0 0 0 0 0 0 0 0 0 0 0 0 0 0 0 0 0 0 0 0 0 0 0 0 0 0 0 0 0 0 0 0 0 0 0 0 0 0 0 0 0 0 0 0 0 0 0 0 0 0 0 0 0 0
